111111111111
100K00A00001
100000000001
100000000001
100000000001
1H0000000002
100000000003
10000000S001
100000000001
100000000001
111111111111