111111111111
1K000A000001
100000000001
100000000001
100000000001
100000000002
100000000003
1H000000S001
100000000001
100000000001
111111111111