111111111111
1K0000000001
111100000001
1A0000000001
111100000001
100000000002
100000000003
1H000000S001
100000000001
100000000001
111111111111