111111111111
100000000001
100000000001
100000000001
100000000001
2P0000000002
300000000003
100000000001
100000000001
100000000001
111111111111