111111111111
100000000001
10000000G001
10G000000001
100000000001
200000000002
300000000003
100000000001
100000G00001
100000000001
111111111111