111111111111
100G00000001
101000000011
100000000G01
100000000001
200000000002
300100000003
100000110001
100000000001
100000000001
111111111111