111111111111
100000000011
100G00000001
100110000001
100000000001
200000000002
300000000003
10000000G001
100000100001
100000000001
111111111111