111111111111
100000000011
100G00000001
100110000001
100000000001
200000000G02
300000000003
1000G000G001
100000100G01
10G000000001
111111111111