111111111111
100000010011
1000000000G1
10GG00010001
110000000001
200000000002
300000000003
100000000001
10000G000111
1G0000000GG1
111111111111