111111111111
100000001001
100110001G01
10GG10001101
111111000001
2000010000G2
300000000003
100000000001
10000000G011
1GG000000111
111111111111