111111111111
111000000001
1GG00000GG01
100000011G01
100000011001
200000000002
300000000003
100000000001
100000000001
100001111GG1
111111111111