111111111111
1000000000G1
100000G00001
10001001G001
100110011001
2000000G0002
3000000G0003
100110011001
100010010001
1G0000000001
111111111111